###############################
#                             #
#                             #
#  X                          #
#                             #
#                             #
###############################
